"a" = (/obj/structure/flora/ausbushes/fullgrass,/turf/simulated/floor/holofloor/grass,/area/holodeck/source_picnicarea)
"b" = (/obj/structure/flora/ausbushes/ywflowers,/turf/simulated/floor/holofloor/grass,/area/holodeck/source_picnicarea)
"c" = (/obj/structure/flora/ausbushes/brflowers,/turf/simulated/floor/holofloor/grass,/area/holodeck/source_picnicarea)
"d" = (/turf/simulated/floor/holofloor/grass,/obj/structure/flora/ausbushes/ywflowers,/turf/simulated/floor/holofloor{dir = 4; icon_state = "wood_siding8"},/area/holodeck/source_picnicarea)
"e" = (/turf/simulated/floor/holofloor/grass,/obj/structure/flora/ausbushes/brflowers,/turf/simulated/floor/holofloor{dir = 4; icon_state = "wood_siding8"},/area/holodeck/source_picnicarea)
"f" = (/turf/simulated/floor/holofloor/grass,/obj/structure/flora/ausbushes/ywflowers,/turf/simulated/floor/holofloor{icon_state = "wood_siding6"; dir = 2},/area/holodeck/source_picnicarea)
"g" = (/turf/simulated/floor/holofloor{icon_state = "asteroid"; dir = 2},/area/holodeck/source_picnicarea)
"h" = (/obj/structure/holostool,/turf/simulated/floor/holofloor{icon_state = "asteroid"; dir = 2},/area/holodeck/source_picnicarea)
"i" = (/turf/simulated/floor/holofloor/grass,/obj/structure/flora/ausbushes/brflowers,/turf/simulated/floor/holofloor{dir = 8; icon_state = "wood_siding2"},/area/holodeck/source_picnicarea)
"j" = (/obj/structure/table/woodentable/holotable,/turf/simulated/floor/holofloor{icon_state = "asteroid"; dir = 2},/area/holodeck/source_picnicarea)
"k" = (/turf/simulated/floor/holofloor/grass,/obj/structure/flora/ausbushes/ywflowers,/turf/simulated/floor/holofloor{dir = 8; icon_state = "wood_siding2"},/area/holodeck/source_picnicarea)
"l" = (/turf/simulated/floor/holofloor/grass,/obj/structure/flora/ausbushes/ywflowers,/turf/simulated/floor/holofloor{icon_state = "wood_siding1"; dir = 2},/area/holodeck/source_picnicarea)
"m" = (/turf/simulated/floor/holofloor/grass,/obj/structure/flora/ausbushes/brflowers,/turf/simulated/floor/holofloor{icon_state = "wood_siding1"; dir = 2},/area/holodeck/source_picnicarea)
"n" = (/turf/simulated/floor/holofloor/grass,/obj/structure/flora/ausbushes/ywflowers,/turf/simulated/floor/holofloor{icon_state = "wood_siding5"; dir = 2},/area/holodeck/source_picnicarea)

(1,1,1) = {"
aaaaaaaaaa
bcbcbcbcbc
cbcdedebcb
defghhgibc
ggggjjgkcb
ggggjjgkcb
lmnghhgibc
cbclmlmbcb
bcbcbcbccb
aaaaaaaaaa
"}
